Нідерланди Нідерланди	Амстердам	Європа
Андорра Андорра	Андорра-ла-Велья	Європа
Греція Греція	Афіни	Європа
Сербія Сербія	Белград	Європа
Німеччина Німеччина	Берлін	Європа
Швейцарія Швейцарія	Берн	Європа
Словаччина Словаччина	Братислава	Європа
Бельгія Бельгія	Брюссель	Європа
Угорщина Угорщина	Будапешт	Європа
Румунія Румунія	Бухарест	Європа
Ліхтенштейн Ліхтенштейн	Вадуц	Європа
Мальта Мальта	Валлетта	Європа
Польща Польща	Варшава	Європа
Ватикан Ватикан	Ватикан	Європа
Австрія Австрія	Відень	Європа
Литва Литва	Вільнюс	Європа
Фінляндія Фінляндія	Гельсінкі	Європа
Ірландія Ірландія	Дублін	Європа
Хорватія Хорватія	Загреб	Європа
Україна Україна	Київ	Європа
Молдова Молдова	Кишинів	Європа
Данія Данія	Копенгаген	Європа
Португалія Португалія	Лісабон	Європа
Велика Британія Велика Британія	Лондон	Європа
Словенія Словенія	Любляна	Європа
Люксембург Люксембург	Люксембург	Європа
Іспанія Іспанія	Мадрид	Європа
Білорусь Білорусь	Мінськ	Європа
Монако Монако	Монако	Європа
Росія Росія	Москва	Європа
Кіпр Кіпр	Нікосія	Європа
Норвегія Норвегія	Осло	Європа
Франція Франція	Париж	Європа
Чорногорія Чорногорія	Подгориця	Європа
Чехія Чехія	Прага	Європа
Ісландія Ісландія	Рейк'явік	Європа
Латвія Латвія	Рига	Європа
Італія Італія	Рим	Європа
Сан-Марино Сан-Марино	Сан-Марино	Європа
Боснія і Герцеговина Боснія і Герцеговина	Сараєво	Європа
Республіка Македонія Македонія	Скоп'є	Європа
Болгарія Болгарія	Софія	Європа
Швеція Швеція	Стокгольм	Європа
Естонія Естонія	Таллінн	Європа
Албанія Албанія	Тирана	Європа
